27 13
#...#######################
#.*.....2#..1....2#.......#
#...#.#.#.#.#.#.#.#.#.#.#.#
#2#..1....#....2#.....1..2#
#.#.#.#.#.#.#.#.#.#.#.#.#.#
#1......2#....1....2#.....#
############.##############
#1......2#....1....2#.....#
#.#.#.#.#.#.#.#.#.#.#.#.#.#
#2#..1....#....2#.....1..2#
#.#.#.#.#.#.#.#.#.#.#.#.#.#
#1......2#..1....2#......&#
###########################