###########################
#1*.....2#..1....2#.......#
#.#.#.1.1.1.1.1.1.1.1.#.#.#
#2#..1....#....2#.....1..2#
#.#.#.1.1.1.1.1.1.1.1.#.#.#
#1......2#....1....2#.....#
#222#.....#12.12#....##222#
#1......2#....1....2#.....#
#.#.#.#.#.#.#.#.#.#.#.#.#.#
#2#..1....#....2#.....1..2#
#.#.#.12222.#.#.#1111.#.#.#
#1......2#..1....2#......&#
###########################

